âba	abe
âga	køre
agga	drille
agorka	agurk
ajl	alt
ajlse	altså
ajt	hensigt
ajta	adlyde
akkorât	lige
alja	gylle
alje	alle
allri	aldrig
allti	altid
âlmingen	almindingen
alt	allerede
ambostuer	forpustet
amma	ligne
andesgår	forgårs
anjelens	anderledes
anjstâ	andensteds
ansajt	ansigt
ansedd	anset
antererd	forbløffet
appârta	mærkelig
appârta	særlig
arbarmelia	gudsjammerlig
arbja	arbejde
ârnâga	arnager
arri	arrig
arri	vred
ârtelihe	artig
astâ	afsted
âu	også
âuerhatt	overstået
aul	husmandssted
aula	pløje
âvisstøkkjer	avisartikler
awtan	aften
âza	slæbe
adsäwijn	gerrig
adsäwijn	grisk
aftan	awtan
agene	køren
agene	kørsel
agersölkje	valmue
agersölkje	kornrose
aisijng	tilhold
akselivång	korndriver
al	ægte
al	rigtig
alâ	ægte
alâ	rigtig
allara	herligt
allara	superb
allara	beundring
anakjökk	stakåndet
anmoda	anmode
antâ	antage
arribigga	arrig kvinde
arrja	ærgre
arrja	ærgeligt
avijllaträ	æbletræ
avijlla hâwa	frugthave med æbletræ
aggenant	prægtig
akkerdera	aftale
akkerdera	forhandle
allians	gode venner
ammelit	passende
ânatrækkj	åndedræt
âria	usikker fortælling
âuanvænnes	oppe efter sygepleje
âvansfujl	fuld af skøre idéer
âvijl	æbletræ
bâ	bade
bâga	bage
bakkasvâla	digesvale
ballra	kvinde, der råber og bruger grove ord
ballrada	stort spektakel, skrald, dunder
bardus	hovedkulds, pludselig
bârfittes	barfodet
barkenaroa	gulerod
barnsli	barnlig
bâza	leder, chef
befænjd	smittet
begjejnelse	begivenhed
begjejnelse	hændelse
behava	synes om
behawa	beghage
beladinj	forlegen
besje	besked
betroninjs	kredit
bia	vente
bidda	stykke, bid af brød eller andet
binja	binde
bjabba	kæfte op
bjæda	bed
bjælan	lille galsindet hund
bjælan	snakkesalig sur kone
bjær	bjerg
bjæra	bjerge, redde
blâ	blad
blâd	blad, avisen
blârar	skinner / stikker i øjnene
blârar	skinne f.eks solen
blo	blod
bloj	bly, undseelig
blojer	bly, undseelig
blojes	skamme sig
blomma	blomst
blossa	blusse
blynkja	blinke
blædda	kokasse / kolort
blæj	bleg
blæjer	bleg
blæjfissinj	blegnæbbet
blåkujla	bloksbjerg
bo	butik
bobba	trold
bojomfru	ekspeditrice
bojsa	rogn, torske bukser
bojser	bukser
bokjøwt	købt i butik
bonalâs	bondetamp
bonarøssen	rønnebær
bone	bonde
bonn	bund
borkj	birk - træ
bortafrå	udenøs (tilflytter)
bossinj	hoved
bossinj	rester af halm / korn
bosta	børste
brâgara	en stor mand
brân	brand
brânter	stejl
bravâs	skrammel, affald
bro	gnide, gnubbe
broer	gnider
bruasænj	brudeseng
bruggla	krølle sammen
bryggja	brygge f.eks øl
bræ	bræt
brø	brød
brøgg	brug
brøggluer	krøllet
brøsoppa	øllebrød
brøssokker	bolsje
brånj	brønd
byjlenbær	blåbær
byskâga	kage
bæjluer	nøgen
bæjluer	skaldet
bækkjastar	solsort
bäla	lune sig
bælla	børn
bælli	barn
bællaajtu	barnagtig
bænkavæjln	ret af ugens mad rester
bænkj	bænk
bær	bedre
bæra	bære
bæsinj	storm med sne og slud
bøja	gnaven
bølinj	pokker
bøja	fornærmet
bølinj	fanden
bølja	bølge
bånge	bange
bønj	by
bläja	blege
bläjfysa	kvinde med blegt, og dårligt udseende
blãjfysing	mand med blegt og dårligt udseeende
blärbögg	tykvom, forædt mand eller dreng
botta	fladfisk
bramma	gøre sig til, bryste sig
brommelbâr	brombær
bråsvalpad	brat, pludselig
byjllamoer	hvid prik i en byld/bums
bällatid	barndom, børneår
bällakjyla	et lavt og tykt barn
böggsula	liden meget tyk forædt kvinde eller pige
böser	ond, slem, gal
bâgdâna	være forsinket
bâgrim	tilbagegang
bajtu	broget
bajtuer	broget
bâliven	store, udstående øjne
barnleja	mad til barselkone
barnost	frygteligt (vejr)
basku  (er)	gråblakket (om ko)
begje	opgive noget
bemømminj	behændig
bjabba	kæfte op
bjæde	stykke jord i have
bjøgg	byg (kornsort)
ble te viners	blive til spot
blåkujlla	høj i østerlars
bojden	på landet
broinjkjætta	troldtøj
bromla	ko, der opfører sig som en tyr
brætt smorr	smeltet smør
bunkalaw	at bo i kollektiv
byssje	seng
bæjlu	nøgen fugleunge
bæjluer	nøgen fugleunge
bæzinj	ondt vejr
bølk	halvvæg i loen
bømpestælinj	sted i lensgårdsskoven
dâ (ejn)	dag
dajs	klokken
dalrar	dingler
dângka	aflive
darra	ryster. dirre
darrelse (fizzel)	sky på leverpostej
darrhænder	ryster på hænder af alderdom
datla	dadle, udsætte på
dâua	due
dâuinj	doven
ded	det
demme	derfor
div	dyb
dokka	dukke
domm	dum
dorras	deres
dovvel	dobbelt
drâfâul	trækfugl
drekk op	drik op
drikka	drikka
droz	bundfald
drudas	skæmte, spøge
dræmma te	slå til
dundra	svire (drikke tur)
duzemânk	utilpas, sløj
duzemânker	utilpas, sløj
dynjastâ	møddingplads
dyza	sove
dæmmenså	basta
dænj	den
dænja	denne
dætta	dette
dæv	døv
dæwlahætta	rappenskralle
dø	tager død på
døblø	blodsamling (under huden)
dølla	skjule, holde hemmeligt
dømmeløggan	påskeugen
dønnar	torden i det fjerne
døppa	sovs, dyppelse
dørrakâr	dørkarm
døtter	datter
dålsada	klosede
dolsa	dovne, smøle
domma	døvstum
drabba	(mand)være langsom, gå og smøle
draddhasa	(kvinde) være langsom, gå og smøle
duggas	der falder dug
dÿrka	blive dyrere, stige i pris
däjggjes	forkælet barn, kæledægge
dämm	mængde
däwlast	mareridt
däwlskaw	djævelskab, spøgeri
dögg	dug, borddug
dölla	skjule, hemmeligt
döller	doven, sløv, langsom, lad
dömnijng	mening, omdømme
dönna	torden
dönnasjy	tordensky
döppa	dyppelse, sauce
dössen	dussin
dalkes	person der går sløvt
dallbâg	forside på svinets hals
dâmajn	morgentøvejr
dâuestol	kornblomst
di sælle	gårdejerfolkene
diggedâr	underlige gebærder
dommedera	kommandere, irettesætte
draddhâz	en, der taber alting
drudas	skæmte, spøge
duzemânk  (er)	træt, utilpas
døinj	genfærd
eddernæjla	brændenælde
edja	tang på strand
enbâr	udelukkend
enjhijlu	mange, en hel del
enjstâ	et sted
ensammer	ensom
enj	en
eina	formaa, være i stand til, overkomme
eita	ægte, (om personer)
eitakvijnna	ægtehustru
eitamanj	ægtemand
enetapp	enebærbusk
ej   (er)	øm i tænderne
ejn knævær	lille mandsperson
ellestingeren	de underjordiske konge
en re	beplantet mark skel
enj dundra	kraftig kvindfolk
enj gjera	det nederste af en skjorte
jønkel	bylt
enj harra	4 fed garn
enj niva	så meget der kan være mellem 2 fingre
enj sagga	langsomt kvindfolk
enj sjinjara	sommerfugl
enj spåmanj	uverhæftig person
enjhijlu	en hel masse
et grøssen	144 stykker
enj bonaryna	en gammel so
dæktara	løgnhals
løvvenasjytt	vagabond
fajlenes fod	gravid
faninj	fanden
faninjatromma	rappenskralde
fanjkinj	fanden
fâr	far
fara	fare
fâra	fare
farres	larme uregerligt
farru	lige ved
farruer	lige ved
farsk	fersk
fâstlan	fastelavn
fatti	fattig
fattier	fattig
fâua	fuge
fâza	fart
figgafagga	pakkenelliker
firafittes	firspring
firavinja	guldsmed (insekt)
firk	en fire i et kortspil
fiskasø	fiskesuppe
fiskje	efterår
fislønkad	lunken (om temperatur)
fiza	lydløs prut
fjællstaun	nattergal
flabbatas	kæphøj / fræk
flabbatass	flab, uforskammet person
flakkar	fod
flarka	kradse i jorden
flarka	spjætte med benene
flarra	rive itu
flarra	flænge (f.eks i tøj )
flâua	flue
flina	grine ondskabsfuldt
flissa	fnise
flojbor	klapbord
flækkja	flække
flærka	drive omkring
flødd	fløde
flå	korkstykke der bindes på sildegarn
fnatta	arbejde hårdt/ skynde sig
fnâza	tølperagtige mandfolk, ustyrlige drenge
fobojl	fodbold
foje	næsten ikke, knap nok
fondass	måde
fondass	facon
fondass	manér
for	før
fordâzad	forslæbt
fordâzad	udslidt
fordæggja	forkælet
forfundrad	tømmermænd
forfundrader	tømmermænd
forfærra	forskrække
forgat	glemt
forgjædda	glemme
forgjøjemaj	en bedyrende ed i lighed med fårbainjemaj
forgrysa	forundre
forgryza	forbavses
forhâua	fortryde
forhauad	angre / fortryde
forhobbad	medtaget
forhobbader	medtaget
forkle	forklæde
forpjøskad	forpjusket
forra	før
forrinj	førend
forstøgga	forvride
fortainj	træt, medtaget, udaset
forvats	forhånd (på)
fost	først
fostninj	begyndelse
fraja	fri
frambi	forbi
frammada	gæster
framtid	forår
frynja	rynke på næsen
frøst	frost
frøstbeddinj	kuldeskær
frøstjyllinj	kuldeskær person
fæggjas	kissemisse
fæggjas	kysse
fæjes	skynde
fækjødd	oksekød
fælâ	kostald
fæstenøl	trolovelsesgilde
fæsø	oksesuppe
fæzelit	forfærdelig meget
følla	følge
førd	tilflytter
førder	tilflytter
førvejslannes	forvekslende
fåje	lille, ubetydelig
fåje	næppe / knap nok
fâlia	meget, særdeles, overmåde
farja	farve
farja	fare, gris der føder
farras	larme, buldre, spektakel
fâster	faster, fars søster
fâst	fast
faun / fawn	favn
feila	fiolin
feliaboua	fiolinbue
fiene	fjende
fijngertüta	fingerhætte, fingerbøl
filkuet	glat, slibrig
fiskje	efterår
fissla	sladre, hemmelig bagvaske
fissletüt	fisler, øretuder
fissletüta	siges om kvindfolk
fittefad	fedtefad, komme i forlegenhed
fittefår	smøl, klodrian
fjäla	fylde i sig, proppe i sig
fjälehorn	pølsehorn (et redskab)
fjäska	trippe, sokke afsted, gå sagte og let
flabb	dum, uforskammet,
flabbatass	næsvis pige eller kone
flärka	sprælle med fødderne
flarra	skramme, rift
faninjahætte	arrigt kvindfolk
farras	skændes og lave larm
farru	rede, parat
farruer	rede, parat
fauna opp	rive sæd i bunker
fed mands plage	kløft i almindingen
figgafagga	pakkenelliker
firafittes	i fuld firspring
fiskjed	efterår
fittefår	smøl, klodrian
fizlønkad  (er)	kuldeslået
fizzelituta	en der insmigrer sig
fizzla	sladre, bagvaske
fjântu	pjattet, fjoget
fjântuer	pjattet, fjoget
fjællstawn	nattergal
flæmta	gispe efter vejret
fnâsu	hensynløs, ligegyldig
fnâsuer	hensynløs, ligegyldig
fnystra	fnise
forgrysd	forundret
forgrysder	forundret
forhobbad  (er)	medtaget af slid
forhoua	fortryde
forkunkla	bringe i urede
forta	skride rask fremad
frakk	frem, pralende
frakker	frem, pralende
frânglu  (er)	fregnet
frejera	spindelvæv
fryna	at rynke på næsen
fæjes	flirte (kys og kram)
fæsø	oksesuppe
gâda	gade
gaddelig	rigelig
gajlnerojs	overstadig fyr
gâla	gale, råbe skrige
galant	fin / nydelig
gallra	sortere
galnarojs	vildbasse
gammajls-åjler	alderdom
gamstajn	kalv
gâst	spøgelse
gâul	gavl
gâuls , på	på vid gab
gawnsgo	tjenstvillig
gjâre	gærde
gje	give
gjeddabuk	gedebuk
gjemijl	gavmild
gjemijler	gavmild
gjerru (er)	arbejdsom, flittig
gjessvassi	forkommende
gjessvassier	forkommende
gjewtefarru	giftefærdig (pige)
gjijle	gilde
gjimmene	gemmested
gjorra	gøre
gjorra	gørre
gjorra ota	stå tidligt op
gjorrviddinj	videbegærlig
gjykkelmâgara	spøgefugl, spasmager
gjynkel	byldt
gjædda	gætte
gjædda (en)	gedde
gjæjl	gæld
gjæjla	gælde
gjærna	gerne
gjæstabodd	selskab
gjæstar	gæster
gjæv	gæv
gjæver	gæv
gjæzlinj	gæsling
gjøj	gøg
gjøkkelmâgara	gøgler
glâna	glo, stirre
glâriven	briller
glâsara	glarmester
glosatter	rasende
glæ	glæde
glømminj	glemsom
gnaddri	gnaven
gnaddrier	gnaven
gnaggla	gnave
gnorra	knurre
gnå	lille arrig tingest
go	gud
goer	god
goll	gulv
gonn	såmænd så…
gosinjad	godhjertet
grajn	fin
grân	smule
grinja	rækværk, gitter
grota	prale
grunju	grublene, tankefuld
grunjuer	grublene, tankefuld
grynkla	klynke, småklage
gryza	gru, forskrækelse
græzænkj	græsenkemand
grøzzlu	grynet
grøzzluer	grynet
gråhajl	kampsten
gråv	grøft
gujl	guld
gæssby	indbyde
gånga	gynge
gångstogga	gående (efter sygdom eller barns første gang)
gåza	gase
gallra	sortere, udsøge
galnarojs	vild dreng
galtaspragla	stenbæk (plante)
gamstajn	kalv
gâst	genfærd
gesvassi  (er)	beleven, forekommende
gjelikk	rask, kvikt
gjemmene	det øverste af en sæk
gjeru  (er)	meget arbejdsom
gjimfujl	det dobbelte af en håndfuld
gjorrviddinj	videbegærlig
gjæstby	gæsteværelse
gloffa	hoste
glosa	være spydig
gniddra	smågrine
granj  (er)	med flotte farver
grinja	jerngelænder
gromma	mørkne (om vejret)
grynkla	småklynke
gulinj	stor sten i havet
gå å kåga	være hoven med næse i sky
gå å læza	gå til præst
gårdrønt	yngste søn på gården
gubba	olding. fabelvæsen.
hâ	have
habba	bide, snappa
hadde	havde
hâga	hage
hagga	en flot fyr (nedsættende)
hajl	hagl
hâla	trække, drage
halldan	sløj
halldan	middelmådig
halsbinje	halstørklæde
hâna	hane
hanj	han
hânkle	håndklæde
hâr	har
harda	tøve / vente
hâred	har det … godt, fint
harmse	harmfuld
harra	harve
haska	klatre
hat	haft
hâua	hue
hâud	hoved
hâupina	hovedpine
hâusa	huske
hawbrynja	strandkant
helu	masse
hez	hæs
hezer	hæs
hijnja	nå, indhente
hitt	fundet
hitta	finde
hitte	fandt
hivad	se dårlig ud / skrante
hodda	udhus
hojensint	hyacint
hojla	holde
hojøst	tale fint / fornemt
holl	hul
hondans	pokkers
honnu	honning
hoppenoller	æblerskiver
horra	dreng
horraknadrinj	magteløs dreng
hosamm	fornem
hosammer	fornem
hozza	strømpe
hozzenål	stoppenål
huinjta torrt	savne mad
hujnta	mangel
hunj	hund
hunjaraja	havloppe
hunjøla	firben
hut	lystre
huz	hus
huzakâta	usselt hus
hyvans	hurtigt / nemt
hyvens	gevaldigt
hæjla	hælde
hæjlu	dejlig, pragtfuld
hæjluer	dejlig, pragtfuld
hællømøssa	allehelgensdag
hælsa	hilse
hælsa (en)	helbred
hælten	halvdelen
hænnu	behændig
hænnua	dygtig til sit arbejde
hævl	høvl
høda	truer med hænderne
høddrar	ryster af kulde
høddrar	skutte sig af kulde
hønna	høne
høra	høre
høsta	høste
høstagjijle	høstgilde
hånnløst	kaste med ting uden at vide, hvor de ender
hånslångara	håndlanger
hårpajs	harpiks
habba	bide
habbeligrâs	barsk og bidende i sin tale
hagga	finmand
hallnad  (er)	fællesskab
halstøddinj	dreng på ca 14 år
hâmpa saj	klæde sig uordentlig
hâmpahuller	lavninger i pedersker
harda	tøve
harrabrer	bred over skuldrene
harrens hænner	plettet gøgeurt
hâuse	hastigt
hawbårn	havkanten
hawraknækkja	meget talende kvinde
haws	vås, vrøvl
hispedehasp	uden ord
homma	flytte sig
houaro	ro i sindet
hunjøla	firben
hæggja	vise omsorg for
hæjlued	kakkelovnskrogen
hæru	spættet
hæruer	spættet
høl	fordybning i vandløb
håananj rynemaj	uvejr med hagl og torden
i faggana	er på vej, står for døren
i åns	før, for et øjeblik siden
ibâg	bag ved
iblann	sommetider, undertiden
idâ	i dag
idå	ud af
ijen	igen
ijl (en)	ild
ijnjen	ingen
ikkje	ikke
ilæl	alligevel
im (enj)	damp
imæl	imellem
ina forr	bange for
inj	ind
injmâri	snedig, udspekuleret
injmârier	snedig, udspekuleret
innjan	inden
iva (et)	øje
iven	øjne
i rykkjatâl	i ubestemte perioder
igna	frygte for
ijlasedder	forhekset
ilidevæl	forbavelsesudbrud
ima	dampe
injsjøg  (er)	syg af mavepine
jâ	jeg
ja min sjænka	ja minsandten
jarn	jern
jarta	hjerte
jâulbør	trillebør
jawn	jævn
jawn me	i samme plan, niveau
jaøl	forlovelsesgilde
jimm	hjem
jimmer	hjemmet
jimmgjewt (en)	medgift, brudeudstyr
jimmsk	halvdum
jyjl	jul
jyjlen	julen
jyjlagass	julehygge
jyjlkat	pindsvin
jælpa	hjælpe
jøs	se godt ud
jøssa saj	pynte sig
jøsses	i..du alt forbarmende
jøttar	vipper / vugger
jawnsies	ved siden af hinanden
jiskersens	du godeste
jomfru krum	lærerinde i rønne
jomfrustykjed	areal i ibsker
jormånad	jordsmon
jylahalm	julegilde
jylalæwa	julebrød
jørnsa grøna ansjajt	23. april
jøtta	løfte
kaffedroz	kaffegrums
kâge	kage
kaja	alikke (fugl)
kajla	kalde
kaklun (enj)	kakkelovn
kammers	kammer
kanj	kan
kanj	kan
kantofla	kartoffel
kântu	kantet
kântuer	kantet
kappes (enj)	fyr, kæreste
kapsion	kaution
kar	mand
kar	vigtig, overlegen
kâr	kar
kârarækkja	tallerkenræke
karra	snitte i små stykker
karsvâusen	giftefærdig (pige)
kâsta	smide, kaste
kastrål	kasserolle
kattajaw	hasteværk
kjâul (enj)	kjole
kjela	kæle
kjesam (mer)	bedrøvet
kjijla	kilde
kjinka	kaste
kjita (en)	spand
kjiv å´d	ked af det
kjyjlemilk (en)	bollemælk
kjyla	melbolle
kjylj	kulde
kjæjhosta	kighoste
kjæjln (enj)	killing
kjæl (enj)	kedel
kjælinj	kælling
kjælinjabør	modvind
kjælka (enj)	kælke
kjænja	kende
kjænjedom (enj)	kundskab
kjærest (enj)	kæreste
kjærka	kirke
kjærna (enj)	kerne
kjærregår (enj)	kirkegård
kjæssa	en ketsjer til at fange noget med
kjætta (en)	hunkat
kjæwt (enj)	kind
kjæwtavarpa	grødske
kjøkka	tåge, dis
kjølna	fyrer op
kjøra	køre
kjøra rawkâna	rutsje nedad på røven
kjøs (enj)	kys
kjøssa	kysse
kjøvva	købe
klaun	kort reb
klava	klage, sladre
klavapinj	klavepind
klen	spinkel
klener	spinkel
klikk	klat af noget blødt
klikk	et lille smæld
klokka (en)	klokke
klæva	klodsmajor
klævsjijd	klodsmajor
klæwet	kløvet
kjølit	koldt
kløpfisk	klipfisk
kløppa (en)	klippe
kløz	klump af et eller andet.
kløz (enj)	jordklump
knabba	banke på, slå på en
knabba	en god portion
knadring	en der er lille af vækst
knarr	en knast i et træ
knul	knold
knul (enj)	knude, hævelse
knækkja	knække
knævær (enj)	undermåler, lille mand
knøddersten (ejn)	småsten
koll	kulde
kolør	farve
komfelut	konvelut
komma op idi´ed	komme galt afsted eller skændes
komma saj	tage på i vægt
komma te	blive født
kondevita (en)	åndsnærværelse
konna	kone
konner	koner
kopattaryzma	kaprifolium
korera	helbrede
korr	kurv
kos	kurs
kos	retning
koss	kors
koss i lidemaj væl	kors
koss i læl	kors
kossinj	frossen i finger eller tæer
krâda saj	modstridig
krajtur	kreatur
krakk (enj)	underskov, krat
kratta	klatre
krâu (enj)	kro
kravla	vikle, smøge
krisk	vammel
krisker	vammel
kriva	krybe
krivvel å kratt	møje og besvær
krægla	mundhugges,  kværulere
krønna	rømme sig
krøssa	knuse
kråga (en)	krage
kråguer	kroget
krakka sijl	ristet sild i kakkelovn
kun	først
kunja	kunne
kunje	kunne
kuta	kludre
kæmpa	kæmpe
kåjl	kold
kåjlebøtta	forlæns kolbøtte
kaffedrivara	snaps efter kaffe
kalladajns	mælke ret
kaperøllika	folkedans
karadolk	lille mandsperson
karolius	skær ved listed
karsnudader	kæphøj
kâsa	gå klodset, skødeløst
kâst	4 stk. sild
kattaiven	små arter af forglemmigej
kattajau	hasteværk
kattamorra	hjemmelavet legetøj
kattasværra	leg på isen
kattaørn	klippe ved allinge
kattøggla	natugle
kjita	spand
kjylemåns	frostperiode
kjæjllnj	killing
kjælinjabør	modvind
kjælinjatænner	kodriver (blomst)
kjænjespâg	har let ved at genkende
kjænjespâger	har let ved at genkende
kjæppstok	del af arbejdsvogn
kjæra	bede indtrængende
kjøddtønjan	stor sten i havet
kladd	gammelt klædningsstykke
klæw	brændeklos
klæwhuz	hus i østerlars
knarr	knast i træ
kniggla	vaklende gang
knøddersten	småsten i vejbelægningen
kopattaryzmer	kaprifolier
krâda	gammel hest
krak	lille, lav skov
krakkaballra	snakkesalig kvinde
krikk	gammel dårlig gående mand
krunekar	stor, flot mand
krusekâga	julebrød
krøk	skrantende person
krømpa	kortspilregnskab
krångla	kværulere
kåsaknajl	fiskegrund ved arnager
kåsatøjed	fiskegrund ved arnager
lided	et lille barn
lâ	lade (stald)
lagna	opløses
lajerstâ	gravsted
lajnta	længes
lajs	laks
lajsa (en)	lektie
larka	lærke
larrit	lærred
lâurda	lørdag
lâuta	lugte
lawa	lave
lâzuer	laset, pjaltet
le	kant, led, retning
ledda	led, låge
lemydier	smidig
lid	lidt
lida på	stole på
lidinj	lille
liggja	ligge
liva	lyve
livæl	alligevel
lojnprost	løgnhals
lojntromma	løgnhals
lojta	lygte
lokka	lykke
lunagoer	lunefuld
lunago	lunefuld
luzablødda	lille kraftig regnbyge
luzagâda	ryg (på et menneske)
luzarævka	lusekrog (skældsord)
lyes	lytter
lyes te	lytte med skeptis
lykkja	løkke
lyz	lys
læggja	lægge
læj	lig
læja	lege
læje	lige
lælle	varsomt, sagte
lær	læder
læwa	leve
læwa	læbe
læza	læse
læzebælli	konfirmand
løddabojser	hængerøvs bukser
løjne	læ
løjta	lygte
løn	lodden
løtt	byrde, løft, tungt løft
løva	løbe
løvenasjøtt	ustyrlig
løvvebasjytt	vagabond
løvved	løbet
lång	lang
långlajd	langagtig i ansigtet
långlajder	langagtig i ansigtet
lårlønkad	lunken (om temeratur)
labatter	fødder
laggna	opløses (sukker i kaffe)
lajlaplugga	æbelsort
lajsa	lektie
lausurt	gul okseøje (blomst)
lemydi	smidig, bøjlig
lemydier	smidig, bøjlig
lissinj	lille
lobbaholl	sumpet sted i skov
lorja	fladbundet båd
lætthænd  (er)	venstrehåndet
lævskræj	løvfrø
læwahuzed	hus i rutsker
lødda	klippe får
løvvenasjytt	vagabond
(i) marken	på besøg
mâd	mad
mâdafåninj	spisning
mâdago	en der laver god mad og ikke er kneben med den
mâdakarpa	madkasse
mâdatid	spisetid
madk	orm, larve
madkådinj	mølædt
mâdmijl	gavmild med mad
mâdurtahawa	køkkenhave
mâdurter	grøntsager
magga sammen	sætte noget sammen, f.eks et brev
majt	magt
mâlurt	malurt
mariblomma	bellis
maripyjta	mariehøne
markløst	uden for vej og sti
mârn	morgen
mârnmål	morgenmad
marsa	marchere,  gå af sted, gå
me	med
meddesmål	middagsmåltid
men	kun
mena om	holder af
mena om	holde af (jeg elsker hende)
mijl	mild
mijnstinj	yngste i familien
milk	mælk
misunjse	misundelig
moer	mor
molka	malke
mollesjøsk	nedtrykt, surmulende
mollesjøsker	nedtrykt, surmulende
mollu (er)	muggen (brød ost osv)
morkj	mørk
morkjbånge	mørkeræd
mosta	at støde
munj	mund
muz	mus
mæljyl	mellemjul
mænjeske	menneske
mænn	kun
mæst	næsten
mæstapârt	størstedel
møss	flere mus
møssa	ballade, uro
målbrøg	sprogbrug
måna	måne
månad	måned
månkera	mangle
majnsa	sildegarn med tilbehør
mâjor	engjord
maksel	klamphuggerarbejde
markløst	gå uden for almindelig vej
meieradrønt	gilde for mejerne
melpave	mark i knudsker
milkatistel	løvetand (blomst)
moffla	prygle, slå løs på
mollesjøsk	surmulende, deprimeret
mollesjøsker	surmulende, deprimeret
mollèt	tabel (lille, stor)
mollevet	menuet
mozzika	skovmærke (plante)
møjdrøssa	urenligt kvindfolk
møllenakka	klippeodde ved svaneke
møsslijng	pelskrave eller kant
nabbas	mundhugges
nâd	noget
naggu	ond/ondskabsfuld
naj	nej
najenhora	nøgen jomfru
najinj	nøgen
najl	negl
nânj	nogen
narrafass	naragtig person
nâue	næppe
ner	ned
nera	nede
niggel	nøgle
nikka å	dø
nikkaløz	leddeløs
niva	brug af fingerspidser, evt salt
nobbesahorra	kæledægge
nogged	noget
nogginj	nogen
nonna	nogle
noran	nordlig
norr	nord
norta	småstjæle
nula	sove lidt
nutijdens	nutidens
nuul	en lille blund
nykommed	nyt og behageligt
nytænninj	nymåne
næbb	næb
nætt	køn, pæn
nætter	køn, pæn
nætter	fin
næzeklud	lommetørklæde
nøijer	dårlig
nøjer	små skavanker
nømma	fatte, nemme
nømminj	let at forstå
nømminj	letopfattende
nøp	lige ved
nøppinj	nippet
nørl	lidt nedsættende om en der arbejder langsomt
nørla	gå,  arbejde langsomt
nåli	ynkelig, syg, elendig
nålier	ynkelig, syg, elendig
nåsammer	sløj, ynkelig
nagg	nøgen
nagger	nøgen
narkjinj	begærlig
nattlyz	krokus
nâuehænn	med nød og næbbe
nidder	garn til sildenet
noldus	fiskegrund ved rønne
nul	blund, lille søvn
nøjer	skrøbeligheder
nøppehuz	hus i rø
nøssel	en der arbejder men ikke udretter meget
nårta	raspe
ojn	ung
ojsa	økse
omgångsmænnjeske	fattiglem
onsinjad	ondsindet
opp i di`ed	uenige
oppa	oppe
oppendawad	opstemt
oppenholler	æbleskiver
oppidi	pilfinger
opplokkad	kød og kartofler branket på en pande
oppsnudad	storsnuet, næsvis
opptojad	optøet
oppvigling	oprør. ophidset til modstand
opsternâsi	trodsig, opsætsig
opsternâsier	trodsig, opsætsig
opsyn	udseende
orstæv	ordsprog
ota	ofte
otast	oftest
ovver	over vandet til f. eks københavn
oasâninj	sandstrækning på hammeren
olagrân	ganske lidt
oles bæstemoer	sten på stranden ved ypnasted
olja	trug til kreaturvanding
onkel og tante	2 klipper ved aarsdale
oppendauad	oprømt, kåd, vild
oppendauader	oprømt, kåd, vild
oppsyn	udseende (især ansigt)
opviglara	urostifter
orstæw	mundheld
ouanrè	overdel til en vogn eller andet
paja	pige på landet
pâl	tyk stok
palta på saj	klæde sig i meget tøj
palthest	klatkage
panja	pande
panjejarn	pandejern
papper	papir
partu	absolut
pensker	fintspisende
pensk	fintspisende
pensker	små spisende
permedikkel	pendul
pibel	pige
piblastabba	teenagepige
pinjes	pinse
pinjstagg	hundestejle
pinkas	parre sig
pirkivad	klatøjet
pjæw	hypokonder
plasér	morskab
plasérlier	morsom
plasérli	morsom
plaserlig	fornøjelig
plokgjæjl	klatgæld
plokka	plukke
pløddra	mudder, søle
plåster	plaster
possa	pose
postinokka	pastinak
pottera	pottemager
prekkevert	pillen. nøjeregnende
prigg	ringeagtende udtryk
prigga	prikke, stikke
prikkeverd	nøjeregende, pertenlig
prikkeverder	nøjeregende, pertenlig
prost	provst
præka	snakke
prækara	prædikant. en der snakker meget
præstakrawa	pinselilje
prøns	prins
pugga	frø  (dyr, ikke plante)
pugga mæ fyjl	chokoladefrø med fyld
pyta	høne
pytt	prut
pælsaralaw	komplot, dårlig selskab
pænja	penge
pøvver	peber
på stunjen	ligestraks
påhitt	påfund
pånå	omtrent
påpaltad	påklædt varmt vintertøj
påpaltader	påklædt varmt vintertøj
påsætter	påtrængende
påzla	pusle
palthest	lille pandekage
peis	smule
perkivad	klatøjet
perkivader	klatøjet
piblastabba	pige på 16-17 år
pilalakken	forundringsudtryk
pjugg	kort tobakspibe
poppersi	apoplexi, slagtilfælde
prunt	punktligt, grundigt
prøvvernikka	konavn
puggemâd	andemad (det grønne på dammen)
pustfujl  (er)	stakåndet
på fajlena fødder	kvinde gravid på 9. måned
på stunjen	om en øjeblik
påpaltad	meget varmt påklædt
påpaltader	meget varmt påklædt
påstæt  (er)	påtrængende
raspa	en uanstændig fræk kvinde
râ	rent, korrekt
rabbar å	går nogenlunde
rabbelikrassa	rappenskralde
râger	ret, rank
râr	sjælden
râr	nydelig, smuk
ravina	nar , fjante
rawsa	rive
râzapaz	spilopmager
rékomm	redekam
resa	rejse
rijsdansk	rigsdansk
rijsspråg	rigssprog
rinj	ring
ripa	gavmild
rogga	fyge
rolisinja	rolig, sindig
rolisinjaer	rolig, sindig
rompa	rumpe
runjlad	rund (om en person)
runjlader	rund (om en person)
runka sønnøp	male sennep i morter
ryggj	ryg
rykkjatâl	periodevis
ryseli	gyselig, skrækkeligt
ryselier	gyselig, skrækkeligt
ræjasmål	rigsmål
ræjtit	rigtig
rælij	grim, hæslig
rælijer	grim, hæslig
rælius	det samme som en styjgjert
rænjesjida	diarré, tynd mave
rævka	skroget. af et dyr eller menneske
ræwben	ribben
rødda	rede, fuglerede
røddinj	rådden
røja	ryge
rølajd	rødlig
rølajder	rødlig
rønsa	rense
røssen	rosin
røstu	rusten
røstuer	rusten
røtta	rotte
røzla	ødsler
rågabogne	fugleskræmsel
rågafnat	skvoflåt
råganat	nat, mørk nat
råz	række, geled
rallika	skældsord
raspa	fræk, uanstændig kvinde
raunnaâs	skældsord
rausa	rive sammen (f.eks græs)
ravina	nar, fjante
rawknækkjelse	at lide ondt
redaja	husholderske
resla	betale enhver sit
rivejæl	ustyrlig unge
rivetinja	rivetand
rizatass	reseda (blomst)
rogg	storm med regn/sne
ræggj	snestorm
ræsta	have gæld
røppene	periode
rågabone	fugleskræmsel
råga-massa-dâ	24. februar
sagla	savle
saj	sig
saja	sige
sajla	sejle
san	sådan
sannsâger	eventyr, fortællinger
sava	sove
seddan	sådan
serla	risle
seva	sæbe
sijl	sild
sjârta	skjorte
sjavs	en person, der pjatter og snakker overfladisk
sjavs	vrøvl
sje	ske
sje	ske, finde sted
sjefta	skifte
sjemodi	sørgmodig, trist
sjev	skib
sjida	pyt
sjikka	sende
sjinjara	sommerfugl
sjyda	skyde
sjyl	skjul
sjæggj	skæg
sjænna	sløv
sjæra	skære
sjæska	slæbende skridt
sjæva	lille stykke af en grannål
sjævla	plyndre, ødelægge
sjødda	bestille noget, lave noget
sjøga	sygdom
sjøkar	sømand
sjørt	skørt
skâ	skade, komme til skade
skadda	skade
skakhâzer	stikpille, spydigheder
skâl	skældsord om dyr eller mennesker
skâla	skræl
skâla	at skule
skallra	rasle med noget
skalra	sladrekælling
skâr	skær
skarnajtu	upålidelig
skarnajtuer	upålidelig
skobba	skubbe
skobbatrâu	drønnert
skoffla å	luske af
skorred	skåret
skorrinj mâd	smørrebrød
skravekâge	efternøler
skrè	tynd skive brød
skree	lille stykke
skringka	spænde ben
skryna	trærod
skryna	hoved (overført betydning)
skryna	skældsord om gammel kælling
skræja	skrige
skygga	skygge
skåjla	skolde
slabba	spilde
slabbedøgg	hagesmæk
slaggu	slap
slaw	slags
slet	glat, jævn
slikku	slikken
slikkuer	slikken
slykkja	slukke
slænt	glide, faldt omkuld
slæføre	snevejr  (slæde føre)
sløggefânt	grovæder
smâl	smal
smida	kaste, smide
smolla	brødsmule
smorr	smør
snajl	snegl
snarka	snorke
snâua	snue
snerta	ung slank pige
snikkara	snedker
sniva	sove
snæwl	snøvl
snøja	liste rundt og snuse
snør	snot
snørdalk	snotklat
snørsnud	snothvapl
snørsnudad	snottet
soggen	sogn
sokerklæw (et)	tvebak
sokkerlâde	chokolade
spâ	spade
spajl	spejl
spiddehozza	strikkestrømpe
spiflâua	spyflue
spinjara	edderkop
spo  (saj)	skynd (sig)
spolagjâre	stakit
spolalågga	stakitlåge
sporr	spurv
sprikka	sprække
språgmanja	sprogmænd
språgskott	sprogbevaring
spæja sijl	spegesild
spåga	splint
staggra	vakle, gå usikkert
staja	stige
stark	stærk
stâua	stue
stijannes	stigende
stjærna	stjerne
stjærnor	stjerner
stobbivad	kortsynet
stoppesera	slå til, række (om penge)
storajtu	storagtig
storajtuer	storagtig
storia	historie
strâger	rank, ret
strânad	strandned
striva	strube, luftrør
strækkja	strække
styggjer	styg, hæslig
stygjert	grim person, både legemligt og åndeligt
stæjla	stille, sætte
stævla	støvle
stæw	støv
stølpa	stolpe
stømmoer	stedmor
stårta	falde
svalp	skvat
svalpa	plaske
svâra	svare
svinka	kort eller hurtig tur
svælja	svulme op
svårt	sort
svårtepølsa	blodpølse
syrk	delvis kælenavn til lille dreng
syzlakonna	snurretop
sælla	sælge
sænj	seng
særissa	fårekylling
sætta	man sætter i jorden på bornholm. man lægger ikke
sæwn	søvn
sø	suppe
sødd	sut
søja	søge
søkkel	cykel
sølkje	silke
søll	sølv
sølla	seler
sømpel	dårlig, ringe
sønnøp	sennep
søvvemâd	skemad
sålæns	således
sångluer	svimmel
sånglu	svimmel
sjita hâusa	dårlig hukommelse
sjovli pyz	en underlig person
sajtlawinj	sagtmodig
sevesant  (er)	pålidelig
sjemodi	modfalden
sjemodier	modfalden
sjidfarru	urenlig person
sjidfarruer	urenlig person
sjiwsasjaws	sludder og vrøvl
sjua	flytte sig
sjænd	spoleret
sjæwblâdada	ranunkel
skâra omm	skifte sind
skarnajtu	uartig
skarnajtuer	uartig
skaventryna	hus ved rø plantage
skraduren	sygelig, skrantende
skringelhâzad	skævbenet
skringelhâzader	skævbenet
skræjelas	sidste høstlæs fra marken
skrønturinj	skulker
skt. mikkels sogn	rutsker
sluna	hænge med hovedet
slunku  (er)	doven, efterladen
slæwsa	kvinde med slæbende gang
sløggefânt	forslugen person
smæjlfajla	skældende kvindfolk
snakka râ	tale rigtigt
snærpelitut	i små kår (mangel, savn)
spekkelerd	snu
spekkelerder	snu
spilla daldos	leve over evne
stâsjunkera	nasturtier (blomst)
sters	køkken
stivvel	kirketårn
stommene	utiltalende mandsperson
stoppesera	klare sig
storivad	forbavset
storivader	forbavset
strânløj	engelskgræs
stæl	areal uden bygninger
stænje	ladeloft
svajl	fugtigt sted på marken
svâledrikka	tyndt, dårlig øl
sylkjentoppa	konavn
sæwlilja	gul eller blå iris
tâ	tag  (tage noget)
tâ klauninj	hænge sig
taddra	sludre
tâg	tag
tagla	gnave, bide
taja	tie
tanj	tand
tanjvark	tandpine
te res	parat
tebâge	tilbage
tefres	tilfreds
temâd	dessert
tetâbælli	plejern
tijle	loft
tjâul	kjole
tjiv	tyv
tjivanåkkel	tyveknægt
tjæra	tjære
tjærka	kirke
tjæta	hunkat med killinger
tjøkk  (er)	tyk
tobbakk	tobak
toffla	tøffel
togga	tygge
toppa	rykke i håret
torra	tørre
tort	tørt
tost	tørst
toza	tosse
trâ	trådt
trattara	tragt
trâua	true
tresk	kvik, ferm, dygtig
trijla	trille
trøbbel	problem
tunghørse	tunghør
tvestarta	ørentvist
tvilna	hælde på - tylle i sig
tyggja	tigge
tæppa	lukke, lukke til
tølla	tåle
tømma	tommelfinger
tøst	tyst, tavs, stille
tåta	tude i horn
tjiva	høtyv
tjivamyrn	moser ved helligdommen
tokkaløs  (er)	ude af sig selv
tormånad	marts måned
torru	tørv
trâ	en trådt sti
trækkjes å	blive fotograferet
tutafait	i en ruf
tisbid	kl. 10 mad
ufajnju  (er)	uhåndterlig
ufnatteli	umådelig
ulada	slemt
uliedier	ulidlig, ækel
ulokka	ulykke
unøtta	vranten
urtakåst	blomsterbuket
ustogga	ustadig
ulabbelit	hæsligt
unbobba	risengrynskage
unjarna	de underste
unnjantag	aftægt
unøtta	sur og tvær
va sâbrikan	hvad pokker
vagga	vugge
vâginj	vågen
vajlabøtta	baglæns kolbøtte
vajta	vinke
vâna	vana
varkan	hverken
varpa	kaste
varpa	smide
varra	være
vâun	vogn
vâuna	vågne
vâuna	vække
vâusa	vokse
vâuta	vogte
vavs	sludder
vâza	vase
veddan	hvordan
ver	ved
vidda	vide
videfrøst	rimfrost
vijla	dygtig
vijlabræ	afveje
vikken	hvilken
viljate	dygtig til
villu	villig
villuer	villig
viner	nar
vinju	vindu
vispa	hveps
visser	kvik, rask
vrântas	mislykkes
vrifitter	klejner
vræla	græde
vyst	lille hund
vystinj	hunden
vyzla	fløjte
værkjikka	vindstød
værkli	virkelig
værsjid	fjært, prut
våraløs	uforsigtig
våraløz	skødeløs
vrångstrivanj	den gale hals
vaita	vinke
vammelmawad  (er)	lidende af kvamle
vannpræstinj	grotte i almindingen
varpa	væveredskab
vaws	vås, vrøvl
vidda hut	opføre sig ordentligt
vijl	særdeles duelig
vijler	særdeles duelig
vijlabræ	udskejelser
vinkeltitta	skeløjet person
viss  (er)	hurtig
vojlløvse	løbsk (hest)
vrângelhorn	krakilsk menneske
vrønna	vrinske (hest)
værkna	fremstille tøj
værsjidaurt	rosen-geranium
vårspring	en slags udslæt
vronginj	fuld
vronginj	beruset
vronginj	forvirret
ynjstinj	yngste
ynka	enkelt
ynra	yngre
æggj	æg
æggla	kværulere
æjle	eller
æjluabid	formiddagsmad
æjnkja	enke
ældra	ældre
ænjastjærna	forglemmigej
ænna	bagdel
ær	ar
ærne	ærinde
ætte	efter
ævarst	øverst
ævent	lige for nyligt
ævent	netop
ænnekehoud	kværulant
ættelækj	sidste del af brændevinsbrænding
øgga	uge
ønte	ikke
øra	øre
ørada	ørred
å	og
åbârad	afslidt
åfø	efterkommere
åjler	alder
ålatælla	åleruse
ålång	aflang
ångest	angst
årsdâlamøj	skvalderkål
åska	aske
åtâinj	fotograferet
åu	også
åviza	avis
åreklæpp	beskyttende beslag på åre
âgerbinnja	snerle
âgerbinnja	vejbinder
âgerkål	agerkål
âgerkål	agersennep
âgerlogg	ager-gåseurt
âgerlogg	agermunk
âgerlogg	kamille
âgermunka	blåhat
âgermunka	skabiose
âger-pænjsurt	pengeurt
âgersølkje	kokkeurt
âgersølkje	kornrose
âgersølkje	valmue
agorka	agurk
agrimonika	agermåne
âhorn	ahorn
alm	elmetræ
alm	skovelm
âluna	alungarve
arter	ærter
asp	bævreasp
aspâsia	asparges
âusel i vång	kodriver
âuselbæratræ	bornholmsk røn
âuselbæratræ	selje-røn
autanstjærna	aftenstjerne
avenbøj	avnbøg
âvijl	æbletræ
bakkamunka	blåmunke
balsompil	balsampil
barkenaroa	gulerod, vild
benedikturt	engnellikerod
benvedje	benved
bittersøda	natskygge
bittersøda	bittersød
bjynk	bynke
bjøgg	byg
blobøj	blodbøg
blomstersæw	iris
blorod	tormentil
blæreklæwer	jordbær-kløver
blåbær	korbær
blåklæwer	anemone
blåklæwer	blåkløver
blåbønna	cikorie
bojseknapp	kornokseøje
bokkablâ	bukkeblad
bokkatorn	bukketorn
bolmaurt	bulmeurt
bonarosa	stokrose
bonarøssen	rønnebær
bonatoza	stokrose
borkj	birk
borra	burre, alle
borrerod	burresnerre
bovedde	boghvede
bozbom	buxbom
brajna	bregne
brânsurt	gøgeurt
brommelbær	brombær
brualyz	brudelys
brøstkjørrild	brystkørvel
brøstkjørrild	sødskærm
brøzzelika	basilikum
brøzzelika	bryselike
byjlenbær	blåbær
bækkja-statât	vandmynte
bæwerasp	bævreasp
bæwergræz	hjertegræs
bødkarasæw	iris
bøj	avnbøg
bøj	bøg
bøllenbær	blåbær
bånpil	båndpil
dâlabær	brombær
dâuestol	kornblomst
dâueurt	dueurt
dâueurt	gederams
dâuevâun	venusvogn
dijl	dild
dikkagræz	vejbred, lancetblad.
draphawra	draphavre
dæwra	dodder
dønæjlla	tvetand
dønæjlla	døvnælde
døsvâmp	giftig svamp
dårtelilja	dorthealilje
eddernæjla	brændenælde
efoi	vedben
enetappa	enebuske
faninjs åbidd	djævelsbid
fâulanæbb	fladbælg, små
fâulanæbb	kællingetand
fâularompa	aks-ærenpris
fâularompa	vejbred, glat
fâulavikka	musevikke
feberklæwer	bukkeblad
fingerborr	blåklokke
fingerborr	digitalis
fingerborr	nælde-klokke
fiol	viol
fiol-matriâla	aftenstjerne
firablâ-ettbær	firblad
fiskanæbb	tigerlilje
floilsgræz	fløjlsgræs
flojlskablomma	fløjlsblomst
flojlstop	dunhammer
flouehaura	flyvehavre
forglimmiej	forglemmigej
førr	fyr
gâdeblomma	gåseurt
gâdeblomma	okseøje
galinjabær	fruebær
gallra	hamp
galnabær	natskygge
galtaspragla	mjødurt
galtaspragla	stenbræk
garsa	rug-hejre
gjeddaløj	skovløg
gjeddarams	ramsløg
gjeddarams	skovløg
gjylenlakka	gyldenlak
gjøjamâd	skovsyre
gjøjnamâd	gøgemad
gjøjnamâd	surkløver
glimmiej	forglemmigej
grânepæra	grankogle
grânesjæwer	grannåle
grizagræz	hjertegræs
græzgarsa	hejre
græzløj	purløg
græznelka	nellike
græzrod	kvikgræs
gråbone	bynke
gråbønna	knopurt
grånakka	knopurt
gråpil	hvidpil
gråtijstel	ager-tidsel
gråtijstel	pigget tidsel
gula-sæw	iris, gul
guleroa, vijl	gulerod, vild
gulklæwer	gul kløver
gulklæwer	humle-sneglebælg
gåzagræz	gåsepotentil
hânapungatræ	benved
hânekomm	kodriver,storblomst.
hâraklæwer	harekløver
harrens hænner	gøgeurt, plettet
hattbær	bakke-jordbær
hattbær	jordbær, vilde
hawentorn	hvidtjørn
hâzzel	hassel
hik	hæg
hinjbæratorn	hindbær
hiventorn	hyben
hiventorn	klipperose
hojensint	hyacint
hojensurt, vijl	scilla
homla	humle
horsatijstel	horse-tidsel
hunjakjajs	kørvel, vild
hunjakjajs	skærmplanter, flere
hunjaløj	vild-løg
hunjatunga	havepest
huzløj	husløg
hyjl	hyld
hæggj	hæg
hæstaklæwer	rødkløver
hæzel i vång	kodriver
hønnusurt	honningurt
hønsagræz	vejpileurt
hønsanæjlla	nælde, liden
hårdenbom	kornel, rød
islandsk the	timian, smalbladet
jacobslilja	lilje, hvid
jarnæg	steneg
jartansfryd	hjertensfryd
jomfru m`s sænjahalm	timian, smalbladet
jomfru m's sænjahalm	snerre, gul
jomfrusarkj	snerle
jorvijntergrønt	singrøn, liden
jyjlkål	skvalderkål
kabbelaja	eng kabbeleje
kaggoræwl	vej-pileurt
kala, vijl	ingefær, dansk
kallarompa	reseda (farve)
kallgårahawra	fuglegræs
kallgårahawra	hønsegræs
kallkræwl	fuglegræs
kalmes, kalmesrod	kalmus
kantofla	kartoffel
karinnetorn	fjeld-ribs
kattafod	fladbælg, gul
kattafod	rundbælg
kattaiven	forglemmigej, små
kattaiven	ærenpris, tveskægget
kattaost	katost
kattapis	scilla
kattarompa, blå	slangehoved
kattatarm	potentil, krybende
kattatarma	fredløs, pengebladet
kjælinjatanj	fladbælg
kjælinjatanj	kodriver, hulkravet
kjælinjatanj	rundbælg
kjælinjatanj, rø	kodriver, melet
kjærnillika	trævlekrone
kjørrije, spansk	kørvel, spansk
kjørrijl	kørvel, have
kjøssebæratræ	kirsebærtræ
klammeri	snerre, gul
klanner	koriander
klitta	klinte
klokka	eng-nellikerod
klokka	klokkeblomst
klokkeblomst	eng-nellikerod
klokkeløng	klokkelyng
klæwer	kløver
kløppeløj	sankt hansurt
klåkotta	hanekro, alle
knoppâgerkål	kiddike
kommian	kommen
kommiansblomma	kamille, vellugtende
kommiansblomma	kamille, ægte
kommianslogg	kamille, vellugtende
kongalyz	kongelys, alle
kongapænn	kongepen
kongsolidarod	læge-kulsukker
kooja	okseøje, hvid
kopatta	eng-nellikerod
kopattarânkla,-ryzma	kaprifolium
kopattarøzmer	gedeblad
kopattarøzmer	kaprifolium
korropil	båndpil
korsbrigna	ørnebregne
krestannatræ	hestekastanie
kruzbær	tyttebær
kruzemyjnt	ager-mynte
krægentræ	kræge
krågetorn	mark-krageklo
kwalkenbær	kvalkved
kwalkentorn	kvalkved
kåjlaurt	hundeviol
lakoja	levkøj
lammaørn	kongelys, alle
lark	lærk
larkelin	spergel
lausurt	gul okseøje
leddagræz	padderokke
leddamunk	ager padderokke
leddasæw	dynd padderokke
lin	hør
linnj	lind, storbladet
lungeblâ	hestehov, filtet
lungeblâ	hestehov, hvid
lyngbær	krækling
lyngbær	revling
lømmika	ærenpris, tykbladet
løng	hedeløng
løngbær	rævling-bær
løngbæraløng	rævling
lønn	ahorn
løvemunj	ager-løvemund
løvemunj	torskemund
madamboner (kartofl)	magnum bonum
mairan	merian
mâlurt	malurt
mâlurt, vijl	bynke, grå
mârhalm	hjelme
mariblomma	bellis
mariblomma	tusindfryd
marsfiol	martsviol
matriâla	aftenstjerne
mattan	matrem
middurt	mjødurt
mijla	strand-mælde
milkafæjlla	høst-borst
milkatijstel	ager-skørtidsel
milkatijstel	ager-svinemælk
milkatijstel	løvetand
milkatijstel	svinetidsel
milkaurt	gaffel-vortemælk
moerurt	kransburre
moerurt	krusemynte
mozzapil	øret pil
mozzapyza	dunhammer
mozzaujl	kæruld
mozzika	skovmærke
munka	brunelle-aks
munka	lancet-vejbred
munkagræz	vejbred, lancetblad.
muzarompa	musehale
mysika	skovmærke
mæsterrod	mesterrod
møllenbær	melbær
møllenbæratræ	axelbær-røn
måzika	bukar
najenhora	nøgen jomfru
najenhora	sommer-hvidblomme
nattskadda	fuglemælk
nålaurt	dueurt, alle
odedâter (kartofler)	up to date
olsurt	brunrod, knoldet
palm	seljepil
palmepil	seljepil
perkom, prikkuer	perikon, prikbladet
perrsla	persille
pil	sølvpoppel
pilsurt	pileurt, bleg
pinjeslilja	pinselilje
pion	pæon
plommetræ	blommetræ
poppelpil	pyramidepoppel
poppelpil	sølvpoppel
postelinsurt	porcelænsblomst
postinokka	pastinak
pottmælka	hyacint
præstakrawa	matrem
præstakrawa	pinselilje
præstaluz	agermåne
præstaluz	burresnerre
puggemâd	andemad
pyretrom	matrem
pænjsurt	pengeurt
pænjsurt	skjaller
pærsla	persille
pærsla, vijl	hundepersille
pøvverrod	peberrod
påskalijla	påskelilje
ramsakål	skovløg
ramsløj	skovløg
râu	rug
riddarasporra	klokkehyacint
riddarasporra	korn-ridderspore
rinjormaurt	vortemælk
risetas, resetas	reseda
rodagræz	kvikgræs
rompehawra	havre
ræwaløng	rævling
ræwarompa	ulvefod
røklæwer	rødkløver
røpil	pil
røpstorn	ribsbusk
sallvaia	eng-salvie
saweknopp	rosengalle
segoria	cikorie
serinatræ	syren
sisarkj	ager-snerle
sjæra	engskær
sjæregræz	hjelme
sjøførr	bjergfyr
skâuâvijl	skovæbletræ
skâujorbær	skovjordbær
skâuskrabba	skovæble
skawgræz	skavgræs
skawtahavra	havre, ikke tærsket
skorrbinja	burresnerre
skorrbinja	hør-silke
skorrbinjer	ager-ranunkel
skræppa	burre, alle
skræppa	skræppe, bredbladet
slånatorn	slåen
smorrblomst	eng-kabbeleje
smorrblomst	ranunkler, alle
smorrurt	ranunkel, langbladet
smorrurt	vorterod
smæjllekotta	blæresmelde
snågabrajna	ørnebregne
snågaurt	konval, stor
soldâtaraknappa	okseøje, gul
solvenn	morgenfrue
solvenn	solsikke
spanskløj	ramsløg
sparrisa	asparges
spærris	asparges
spøl	tagrør
staggerløj	sandløg
staggerurt	feber-nellikerod
stâsjunkara	nasturtier
stâsmoskat	pelargonie, engelsk
statât	mynte, grøn
stavrløj	ramsløg
stavrløj	sandløg
stenbrigna	engelsød
stikkelsbæratorn	stikkelsbær
stikketijstel	tidsel, lav
stolt henrik	brandbæger
stor-vie	gråpil
strânløj	engelskgræs
strântistel	strand-mandstro
stømmoer, vijl	ager-stedmoder
stångrosa	stokrose
svinabostagræz	katteskæg
svinatistel	svinemælk
svårtebær	rævling-bær
svårthâuda	lancet vejbred
svårtvedje	tørstetræ
swânikaguleroer	skvalderkål
swinamijla	gåsefod, hvidmelet
swinamijla	svine-mælde
swinatijstel	ager-skørtidsel
swinatijstel	ager-svinemælk
sylkjeurt	valmue
syra	skræppe, kruset
sæ	sæd, korn
sæksinia	snerre, gul
sæw	knop-siv
sæwævja	bændeltang
søldanna,søldannarod	svaleurt
sølkjegræz	mose bunke
sølkjesarkj	snerle
sølkjeurt	trævlekrone
søvverinstræ	syren
tappsjæra	reseda (farve)
tijstel	tidsel, alle
tjæraurt	tjærenellike
toppsjæra	kongelys, alle
træâgerkål	kiddike
trækorn	kiddike
tulipân, vijl	tulipan, vild
tæpprawa	gulerod, vild
tæpprawa	røllike
tøttebær	tyttebær
urtakåst	blomsterbuket
vajbrødblâ	vejbred, glat
valriâna	læge-baldrian
vannanemon	vandranunkel
vannpil	skørpil
vannpostinakka	mærke, bredbladet
vannpøvver	ranunkel, nedbøjet
vedde	hvede
vidbøj	avnbøg
vidklæwer	hvidkløver
vidløj	ramsløg
vie	pil, krybende
viggasæw	lyse-siv
vijntergrønt	vedben
vijntergrønt	vintergrønt
vijnternarr	gækurt
vijnternarr	vintergæk
vijnternarr	vintergæk
vijnternarr	vårgæk
vinervâun	venusvogn
vinngræz	vindaks
værsjidaurt	storkenæb, stinkende
vårtemilk	gaffel-vortemælk
vårtorn	korsved
vårtorn	vrietorn
æj	eg
æjnjalogg	okseøje, hvid
æl	rødel
ælletræ	rødel
ællekrak	ellekrat
ælnerod	læge-alant
ængeltorn	æblerose
ænjaklokka	klokkeblomst
ænjasjæra	skjaller, stor
ænjastjærna	engstjerne
ænjastjærna	forglemmigej
ænjasølkje	trævlekrone
ænjklokka	eng-nellikerod
ænjpænj	skjaller
ænjsjær	engskær
ænjzamunka	djævelsbid
ævja, ædja	tang (opdrevet)
øzelvång	kodriver, hulkravet
åjlenbøj	bøg
årsdâlamøj	skvalderkål
agerhønna	vagtelkonge
âgerhønna	engsnarre
agerpyta	vagtel
agerriksa	vagtelkonge
ân	and
bakkasvâla	digesvale
blânke-kniv	hvinand
blânkenkniv	tejst
blå råg	sortkrage
blånæbba	bjergand
bofinka	bogfinke
bogfinkahøj	spurvehøg
boskahøj	tornskade, rødrygget
boskajælpa	bynkefugl
brokkfâul	brokfugl
brunnakka	brunnakke
brunnakka	pibeand
brunskalla	munk
bruus-kop	hvinand
bækkjastar	solsort
dâua	due
dâuehøj	duehøg
dâuehøj	hvepsevåge
dokkert	dykand
dolken	strandhjejle
donpap	dompap
drâfâul	trækfugl
drapgåz	knortegås
drivfâul	storspove
fâula	dykænder, fællesnavn
fiskasnærlinj	snærling
fittsmula	præstekrave, stor
fjællstaun	nattergal
fjærapist	præstekrave
fjærapist	ryle
floifâul	trækfugl
floita	vadefugle, små
flojtatuta	hjejle
flæskatjiv	musvit
gaddiz	havlit
gjârekonge	gærdesmutte
gjøj	gøg
glint	glente
gompafâul	halemejse
grawgåz	gravand
græzân	ænder,(ruger i græs)
gråben	høg
gråben	stormmåge
gråerska,-irska	tornirisk
grånakka	stormmåge
gråsporr	gråspurv
gråvælminj	bomlærke
gråvælminj	kornværling
gul skra	skallesluger, stor
gulskrækkja	skallesluger, stor
gulvælminj	gulspurv
gåza	gase
hâbak	høg
hakkespæt	flagspætte, stor
hâpax	tornskade, stor
haurafâul	vipstjert
hawaærska, -erska	havesanger
hawfâul	dykænder, alle slags
hawrapinkes	vipstjert, gul, hvid
horsagjøj	bekkasin
hvi(d)sia	hvinand
hvi(d)sia	skallesluger, toppet
hætting-tærna	dougalls terne
høj	høg
kaja	allike
kakatrost	sangdrossel
kattøgla	natugle
kivio	kjove
kjirra	fjordterne
kjirra	hætteterne*
kjærra	fjordterne
kjærra	sorthætte*
kjøssebærafâul	havesanger
klaeshahn	havlit
klaeshahn	hvinand
kniva	hvinand
kongefâul	fuglekonge
kovverân	taffeland
krakkøgla	natugle
krek(kruk)-kop	taffeland
kråga	krage
larka	lærke
lâsagjæss	gæs m. løse fjer
lijla måga	dværgmåge
lijla sølvet	måge, tretået
lijla sølvet	ride
lynglarka	toplarka
lyngpivara	hjejle
lyngvrinskinj	horsegøg
långviva	brokfugl
mula	alk
mula	lomvie, langnæbbet
muzavitta	musvit
nattbagg	natravn
oert	krikand
perleân	spidsand
perlemåga	sølvmåge
pivara	regnspova
pomeransfâul	pomeransfugl
pærka	and
rajnfâul	mursvale
rajnsvâla	mursejler
rawn	ravn
ringeldâua	ringdue, stor blågrå
ringvia	lomvie, langnæbbet
rytara	præstekrave, stor
rytara	ride
rytarinj	ryle, sortgrå
røjælpa	irisk
røkjinka	rødhals
røkjælk	rødhals
røkroes	rødhals
røtterinj	måge, tretået
røtterinj	ride
råg	kornkrage, blå
råg	råge
sânrujla	præstekrave, stor
sânrujla	ryle
sân-vrifter	præstekrave, stor
savfilarinj	musvit
savnæbba	skallesluger
savnæbba	skeand
sijlaperris	tejst
simmerinj	sjagger
sitronfâul	pomeransfugl
sjitafâul	silkehale
sjitarinj	silkehale
sjitsnappara	kjove
sjødâua	tejst
sjøhâna	lom, 3 arter
sjøhønna	lappedykker, toppet
sjølarka	snespurv
sjøpoppelgoja	alk
skadda	skade
skræjkkja	skallesluger, toppet
skræjkkj-ân	skallesluger, toppet
skuda	skovdue
snefâul	snespurv
snæra	misteldrossel
sporr	spurv
sporrahøj	spurvehøg
sporrahøj	tårnfalk
starr	stær
stenjælpa	digesmutte
stenjælpa	stenpikker
stenjælpa	vipstjert
stenpikkara	vipstjert
stenpinkes	vipstjert, hvid
stokkân	sædgås
strânbækkasin	tinksmed
strân-høj	kjove, lille
strânpivara	sandløber
strânrujla	præstekrave, stor
strøm-ân	gråand
strøm-ân	stokand
stråfâul	vipstjert, gul
svân	svane
svensk bogfinka	kvækerfinke
svenska	grønirisk
svenskinj	lom, rødstrubet
svårthætta	fjordterne
svårthætta	hætteterne*
svårtkjirra	sortterne
søllskrækkje	skallesluger
tolk	rødben
trâna	trane
trappgåz	knortegås
træpikkara	flagspætte
tællepikkara	musvit
tømmalidinj	fuglekonge
vajdetitta	stenvender
viindrossla	sangdrossel
vijlân	gråand
vijntermåga	tretået måge
virla	mudderklire
viva	vibe
ænjasnarra	engsnarre
ænjasnarra	vagtelkonge
ærinjsfâul	vagtel
åbo	edderfugl
ålakråga	skarv
ångelmuz	angelmus
hunj	hund
vyjst	hund, lille
kjætta	hunkat
kjæjln	killing
âgerstaggra	markmus
muz (flertal møss)	mus
jyjlkat	pindsvin
røtta	rotte
ångelmuz	spidsmus
ansiosa	ansjos
ædjapytta	blåmusling
brillinj	brisling
gjædda	gedde
hunjfisk	hundestejle
pinjstagg	hundestejle
slætta	ising
kroppa	karudse
lajs	laks
svelling	laks, ung, lille
mossla	musling
botta	pighvar
sijl	sild
skrobba	skrubbe
sânrujltes	smørbutting
sânrujltes	sortkutting
sudara	suder
sjælhunj	sælhund
âdak	sælhund
næbgjædda	tangsnarre
tobbis	tobis
storje	tobis
fisk	torsk
sijlakâga	vandmand
vannsvavel	vandmand
ørada	ørred
sigge	ørred, lille
minka	ålekvabbe
særissa	ager-fårekylling
visa	bidronning
brøms	bremse
bænkjaskrobba	bænkebider
spinnjara	edderkop
flâua	flue
sirissa	fårekylling
sirris	fårekylling
tossebid	gordius(latin,slægt)
græzhoppara	græshoppe
firavinjara	guldsmed
gjæstaboddsbeara	guldøje
hunjaraja	havloppe
horsasnorra	hestebremse
horsaflâua	hestebremse
vispa	hveps
skâlmadk	insekt m. hård skal
kålsjinjara	kålsommerfugl
loppa	loppe
grånakka	lus
gråbena	lus
luz	lus
ængra	maddike (i kød)
marripyjta	mariehøne
lokka	mejer
vandlokka	mejer
sjinjara	møl, flyvende
sjinjara	natsværmer
nattbuggara	natsværmere, store
madk	orm, larve
grajnja orm	sankthansorm
torrbag	skarnbasse
rågafnat	skovflåt
snågaspott	skumcikade som puppe
elefânt	snudebille
sjinjara	sommerfugl
frajara	spindelvæv
spiflâua	spyflue
væggjasijl	sølvkræ
hunjaraja	tangloppe
mørl, mærl	tangloppe
torrbag	torbist
vårtebidara	vortebider
tvestarta	ørentvist
eil	igle
ajla	igle
hunjøla	firben
jordrøm, -drøn	klokkefrø
kongesalamander	salamander, stor
læwskræj	løvfrø
løngtobbis	firben
orm	slange (alle slags)
ormslåer	hugorm
ormslåer	stålorm
pugga	frø
rørdrom	klokkefrø
snajl	snegl
snåga	snog
stenjælpa	snog
tinjstâvisper	haletudser
vannøla	salamander
Âlinga	Allinge
Ârnâga	Arnager
Hâzle	Hasle
Helipær	Helligpeder
Klæmsker	Klemensker
Najsø	Neksø
Najsø	Nexø
Pærsker	Pedersker
Rø	Rø
Rønna	Rønne
Svânikka	Svaneke
Tajlkås	Teglkås
Tajn	Tejn
Tâuta	Tofte
Ypnastâ	Ypnasted
dâuaodda	dueodde
lista	listed
nykjærke	nyker
mulaby	muleby
svårthatt	sorthat
enj	1
to	2
træ	3
fira	4
fæm	5
sajs	6
sju	7
åta	8
ni	9
ti	10
ælua	11
tâl	12
trætan	13
fjaurtan	14
fæmtan	15
sajstan	16
søtan	17
atan	18
nøtan	19
tyva	20
træva	30
fåra	40
haltrøs	50
trøs	60
halfjærs	70
fers	80
halfæms	90
honrada	100
tuzen	1000
